111111
103001
100021
100001
111111
